COMPLACENCY  	K AH M P L EY S AH N S IY
PHLEGMATIC 	F L EH G M AE T IH K
PROMULGATED 	P R AA M AH L G EY T AH D
PITTANCE 	P IH T AH N S
MISNOMER 	M IH S N OW M ER
CLANNDESTINE  	K L AE N D AH S T AY N
ARMOURY  	AA R M ER IY
QUACKS 	K W AE K S
GENUFACT 	JH EH N Y UW F AH K T
BLATANT 	B L EY T AH N T
COMMISERATE 	K AH M IH S ER EY T
ABANDON	AH B AE N D AH N
ABANDONED	AH B AE N D AH N D
ABILITY	AH B IH L AH T IY
ABLE	EY B AH L
ABOUT	AH B AW T
ABOVE	AH B AH V
ABROAD	AH B R AO D
ABSENCE	AE B S AH N S
ABSENT	AE B S AH N T
ABSOLUTE	AE B S AH L UW T
ABSOLUTELY	AE B S AH L UW T L IY
ABSORB	AH B Z AO R B
ABUSE	AH B Y UW S
ABUSE(2)	AH B Y UW Z
ABUSE	AH B Y UW S
ABUSE(2)	AH B Y UW Z
ACADEMIC	AE K AH D EH M IH K
ACCENT	AH K S EH N T
ACCENT(2)	AE K S EH N T
ACCEPT	AE K S EH P T
ACCEPT(2)	AH K S EH P T
ACCEPTABLE	AE K S EH P T AH B AH L
ACCEPTABLE(2)	AH K S EH P T AH B AH L
ACCESS	AE K S EH S
ACCIDENT	AE K S AH D AH N T
ACCIDENTAL	AE K S AH D EH N T AH L
ACCIDENTAL(2)	AE K S AH D EH N AH L
ACCIDENTALLY	AE K S AH D EH N T AH L IY
ACCIDENTALLY(2)	AE K S AH D EH N AH L IY
